1111111
1P000C1
101X101
100C001
1110E11
1111111
