1111111111
1P000C0001
101X101111
100C000001
1000E01001
1111111111
