11111111111
1P000100001
11101010101
10001010101
10111010101
10100010001
10001111101
10100000101
11111110101
1C000000E01
11111111111
