11111111111
1P0000000C1
10111111101
10100000101
10101110101
10101010101
10101010101
10101010101
10100000101
1E000000001
11111111111
