1111111
1PP00C1
1011101
100C001
1110E11
1111111
