1111110
1P000C0
1011100
100C000
1110E10
1111110
