1111111
1P00001
1011101
1000001
1110E11
1111111
