1111111
1P000C1
1011101
100C001
1110011
1111111
