1111111
1P000C1
1011101
100C0011
1110E11
1111111
