11111
P0001
101C1
100E1
11111
