1111111
1P00001
1111101
10C0101
1110E11
1111111
